#######B###
#     #   #
# ### ### #
# #     # #
# # ### # #
#   # #   #
### # ##### 
#     #   #
##### # # #
A       # #
###########
