####################
#     #       #    #
# ### # ##### # ## #
# #   #     # #    #
# # ####### # ######
# #       # #      #
# ####### # ###### #
#       # #      # #
##### # # ###### # #
#   # # #      # # #
# # # # ###### # # #
# #   #    A # #   #
# ######### # ######
#         # #      B
####################