###############################
#A    #      #       #      ###
# ### # #### # ##### # #### ###
#   # #    # #     # #    # ###
### # #### # ##### # #### # ###
#   #      #       #      # ###
# ##### #### ##### ##### ### ##
#     #  # #     #       #   ##
##### # ## # ### ##### ### # ##
#     #    #   #     #   # # ##
# ##### #### # ##### # ### # ##
#      #     #       #     # ##
#### ### ### # ##### ##### # ##
#          # #             # B#
###############################